1111111111111
1C0001C000001
10110101011C1
1001000101001
1101110100011
1P01E00C01001
1111111111111
