1111111111111
1C000100000C1
1011010101101
1001000101001
1101110100011
1P01E00001001
1111111111111
