	  1
     101
    10E01
   1000001
  100000C01
 10P00000001
1111111111111

1111111111111
1000000000001
10000C000E001
10P0000000000
1111111111111

1111111111111
1000000100001
10000C010E001
10P0000100001
1111111111111

1111111111111
1000000000001
10000C0000001
10P0000000001
1111111111111

1111111111111
1000000000001
10000C0000E01
1000000000001
1111111111111

1111111111111
1000000000001
1000000000E01
10P0000000001
1111111111111
