1111111111111111111111111111111111111111111111111111111111111111111111111111111111111111111111111111
1000000000000000000000000000000000000000000000000000000000000000000000000000000000000000000000000001
1000000000000000000000000000000000000000000000000000000000000000000000000000000000000000000000000001
1001111111111111111111111111111111111111111111111111111111111111111111111111111111111111111111111001
1001000000000000000000000000000000000000000000000000000000000000000000000000000000000000000000001001
1001000000000000000000000000000000000000000000000000000000000000000000000000000000000000000000000001
1001001111111111111111111111111111111111111111111111111111111111111111111111111111111111111111001001
1001001000000000000000000000000000000000000000000000000000000000000000000000000000000000000001001001
1001001000000000000000000000000000000000000000000000000000000000000000000000000000000000000001001001
1001001001111111111111111111111111111111111111111111111111111111111111111111111111111111111001001001
1001001001000000000000000000000000000000000000000000000000000000000000000000000000000000001001001001
1001001001000000000000000000000000000000000000000000000000000000000000000000000000000000001001001001
1001001001001111111111111111111111111111111111111111111111111111111111111111111111111111001001001001
1001001001001000000000000000000000000000000000000000000000000000000000000000000000000001001001001001
1001001001001000000000000000000000000000000000000000000000000000000000000000000000000001001001001001
1001001001001001111111111111111111111111111111111111111111111111111111111111111111111001001001001001
1001001001001001000000000000000000000000000000000000000000000000000000000000000000001001001001001001
1001001001001001000000000000000000000000000000000000000000000000000000000000000000001001001001001001
1001001001001001001111111111111111111111111111111111111111111111111111111111111111001001001001001001
1001001001001001001000000000000000000000000000000000000000000000000000000000000001001001001001001001
1001001001001001001000000000000000000000000000000000000000000000000000000000000001001001001001001001
1001001001001001001001111111111111111111111111111111111111111111111111111111111001001001001001001001
1001001001001001001001000000000000000000000000000000000000000000000000000000001001001001001001001001
1001001001001001001001000000000000000000000000000000000000000000000000000000001001001001001001001001
1001001001001001001001001111111111111111111111111111111111111111111111111111001001001001001001001001
10010010010010010010010010000E0000000000000000000000000000000000000000000000001001001001001001001001
100100100100100100100100100000C000000000000000000000000000000000000000000000001001001001001001001001
1001001001001001001001001111111111111111111111111111111111111111111111111111111001001001001001001001
1001001001001001001001000000000000000000000000000000000000000000000000000000000001001001001001001001
1001001001001001001001000000000000000000000000000000000000000000000000000000000001001001001001001001
1001001001001001001001111111111111111111111111111111111111111111111111111111111111001001001001001001
1001001001001001001000000000000000000000000000000000000000000000000000000000000000001001001001001001
1001001001001001001000000000000000000000000000000000000000000000000000000000000000001001001001001001
1001001001001001001111111111111111111111111111111111111111111111111111111111111111111001001001001001
1001001001001001000000000000000000000000000000000000000000000000000000000000000000000001001001001001
1001001001001001000000000000000000000000000000000000000000000000000000000000000000000001001001001001
1001001001001001111111111111111111111111111111111111111111111111111111111111111111111111001001001001
1001001001001000000000000000000000000000000000000000000000000000000000000000000000000000001001001001
1001001001001000000000000000000000000000000000000000000000000000000000000000000000000000001001001001
1001001001001111111111111111111111111111111111111111111111111111111111111111111111111111111001001001
1001001001000000000000000000000000000000000000000000000000000000000000000000000000000000000001001001
1001001001000000000000000000000000000000000000000000000000000000000000000000000000000000000001001001
1001001001111111111111111111111111111111111111111111111111111111111111111111111111111111111111001001
1001001000000000000000000000000000000000000000000000000000000000000000000000000000000000000000001001
1001001000000000000000000000000000000000000000000000000000000000000000000000000000000000000000001001
1001001111111111111111111111111111111111111111111111111111111111111111111111111111111111111111111001
1001000000000000000000000000000000000000000000000000000000000000000000000000000000000000000000000001
1001000000000000000000000000000000000000000000000000000000000000000000000000000000000000000000000001
1001111111111111111111111111111111111111111111111111111111111111111111111111111111111111111111111111
1000000000000000000000000000000000000000000000000000000000000000000000000000000000000000000000000001
1000000000000000000000000000000000000000000000000000000000000000000000000000000000000000000000000P01
1111111111111111111111111111111111111111111111111111111111111111111111111111111111111111111111111111
